0 0 0 0 0 0 1 1 1 1 1 0 0 0 0 0 0 0
0 8 0 0 0 0 6 0 0 0 6 0 0 0 0 0 8 0
0 0 0 0 0 0 6 6 6 6 6 0 0 0 0 0 0 0
0 0 0 0 0 0 0 0 0 0 0 0 0 0 0 0 0 0
7 7 7 7 0 8 0 0 0 0 0 0 8 0 7 7 7 7
7 7 7 7 7 7 7 1 0 0 0 7 7 7 7 7 7 7
7 7 7 7 0 0 3 1 0 0 0 0 1 6 7 7 7 7
6 8 0 0 0 0 6 3 0 0 0 0 0 0 0 0 8 0
1 0 0 0 0 0 0 0 0 0 0 0 0 0 0 0 0 0
3 0 0 0 0 0 6 6 6 6 6 0 0 0 0 0 0 0
3 8 0 0 0 0 6 0 0 0 6 0 0 0 8 8 8 0
0 0 0 0 0 0 1 1 1 1 1 0 0 0 0 0 0 0